NO ./texture_for_cub/brick.xpm
SO ./texture_for_cub/metal.xpm
WE ./texture_for_cub/sheika.xpm
EA ./texture_for_cub/triforce.xpm






F 220,100,0
C 225,30,0

1111111111111111111111111
1000000000110000000000001
1011000001110000000000001
10010000000000000000000011111111
111111111011000001110000000000001
100000000011000001110111111111111
11110111111111011100000010001001
111101111111110111010100100010001
11000000110101011100000010001111
1000000000000000110000001001
10000000000000001101010010001
110000011101010111110111100111
11110111 1110101 101111010001
11111111 1111111 111111111111
