NO ./texture_for_cub/brick.xpm
SO ./texture_for_cub/metal.xpm
WE ./texture_for_cub/sheika.xpm
EA ./texture_for_cub/triforce.xpm






F 100,200,50
C 225,30,50

111111111111
100000000001
100010000001
100010000001
100000100101
100000000001
100000000001
1000S0000001
111111111111
