NO ./texture_for_cub/brick.xpm
SO ./texture_for_cub/metal.xpm
WE ./texture_for_cub/sheika.xpm
EA ./texture_for_cub/triforce.xpm






F 220,100,0
C 225,30,0

1111111111111111111111111111111111111111111111111111111111111111111111111111111
1000000000110000000000001000000000000000000000000000000000000001000000000000001
1011000001110000000000001000000000000000000000000000000000000001000000000000001
1001000000000000000000001111111100000000000000000000000000000001000000000000001
1111111110110000011100000000000010000000000000000000000000000010000000000000001
1000000000110000011101111111111110000000000000000000000000000010000000000000001
11110111111111011100000010001001000000000000000000000000000000100000000000000001
11110111111111011101010010001000100000000000000000000000000000100000000000000001
1100000011010101110000001000111100000000000000000000000000000010000000000000001
1000000000000000110000001001000000000000000000000000000000000010000000000000001
1000000000000000110101001000111111111111111111111111111111111111111111111111111
110000011101010111110111100111
11110111 1110101 1011110100N1
11111111 1111111 111111111111
