111111111
100000001
1000N0101
100000001
111111111

111111111
100000001
100020101
100000001
111111111
