111111111
100000001
100000001
1000N0101
100000001
111111111
