11111111111111111111111
1000000000N000000E00001
11111111111111111111111
