NO ./textures/no.xpm
SO     ./textures/so.xpm
WE ./textures/we.xpm
    EA       ./textures/ea.xpm
F +26,085,000000000000000000000000000000000000000000000000000000000000000000000000000000000000000000000000000000000000000000000000000000000000000000000000000000000000000000000000000000000000000000000000000087
C 0     ,           167     ,      170
11111
10001
10E01
10001
11111
